几几几几几几几几几几几几几几几几几几几
几几几几几几几几几几几几几几几几几几几
几几几几几吧几几几吧几几几几几几几几几
几几几几几吧吧几几吧几几几几几几几几几
几几几几几吧几几吧几几几几几几几几几几
几几几几吧几几吧吧吧吧吧吧吧吧吧几几几
几几几几吧几几吧几吧几几几几几几几几几
几几几吧吧几吧几几吧几几几吧几几几几几
几几吧几吧几几几几吧吧吧吧吧吧几几几几
几吧几几吧几几几几吧几几几几几几几几几
几几几几吧几几几几吧几几几几几几几几几
几几几几吧几几几几吧几几几几吧几几几几
几几几几吧几几几几吧吧吧吧吧吧吧几几几
几几几几吧几几几几吧几几几几几几几几几
几几几几吧几几几几吧几几几几几几几几几
几几几几吧几几几几吧几几几几几几几几几
几几几几吧几几几几吧几几几几几几几几几
几几几几吧几几几几吧几几几几几几几几几
几几几几几几几几几几几几几几几几几几几
几几几几几几几几几几几几几几几几几几几

几几几几几几几几几几几几几几几几几几几
几几几几几几几几几几几几几几几几几几几
几几几几几吧几几几几几吧几几几几几几几
几几吧几几吧几几吧几几吧几几几几几几几
几几几吧几吧几吧几几吧吧吧吧吧吧几几几
几几吧吧吧吧吧吧吧几吧几几几吧几几几几
几几吧几几吧几几吧吧几吧几几吧几几几几
几几吧几吧吧吧几吧几几几吧吧几几几几几
几几吧吧几吧几吧吧几几吧几吧几几几几几
几几吧几几吧几几吧几吧几几几吧吧几几几
几几吧几几几几吧吧几几几几几吧几几几几
几几几几几吧几几几几几吧几几几几几几几
几吧吧吧吧吧吧吧吧吧吧吧吧吧吧吧几几几
几几几几几吧几几几几几吧几几几几几几几
几几几几几吧几几几几几吧几几几几几几几
几几几几吧几几几几几几吧几几几几几几几
几几几几吧几几几几几几吧几几几几几几几
几几几吧几几几几几几几吧几几几几几几几
几几几几几几几几几几几几几几几几几几几
几几几几几几几几几几几几几几几几几几几

几几几几几几几几几几几几几几几几几几几
几几几几几几几几几几几几几几几几几几几
几几吧几几几几几几吧几几几几几几几几几
几几几吧几几几几几几吧几几几几几几几几
几几几吧几吧吧吧吧吧吧吧吧吧吧吧几几几
几几几几几几几几吧几几吧几几几几几几几
几吧几几几几几吧几几几几吧吧几几几几几
几几吧几几几吧几几吧几几几吧几几几几几
几几吧几吧几几几吧几几吧几几几几几几几
几几几几吧几几吧吧吧吧吧吧几几几几几几
几几几几吧几几几几吧几几吧几几几几几几
几几几吧几几几几吧吧几几几吧几几几几几
几几几吧几几几吧几几吧几吧几几几几几几
几吧吧吧几几吧吧几几几吧几几几几几几几
几几几吧吧吧几吧几几几几吧几几几几几几
几几几吧几几几吧几吧几几几吧几几几几几
几几几吧几几几吧吧几几几几吧吧吧几几几
几几几吧几几几吧几几几几几几吧几几几几
几几几几几几几几几几几几几几几几几几几
几几几几几几几几几几几几几几几几几几几
